0	0	0	0	0	0	0	0	0	0
0	2	4	6	8	11	15	11	8	0
0	1	8	15	20	40	10	9	7	2
0	-1	-4	7	9	4	1	3	4	0
0	-6	-10	-40	-15	-6	1	2	3	4
0	0	0	0	0	0	0	0	0	0
